111111111111111111111111111
100000000000010000000000001
101111011111010111110111101
101111011111010111110111101
101111011111010111110111101
100000000000000000000000001
101111010111111111010111101
100000010000010000010000001
111111011111010111110111111
111111010000010000010111111
111111010111111111010111111
111111010C0000000C010111111
100000000111101111000000001
1111110101000E0001010111111
111111010111111111010111111
111111010000000000010111111
111111010111111111010111111
100000000000111000000000P01
101111011110111011110111101
100001000010000010000100001
111101011011111110110101111
100000011000010000110000001
101111111111010111111111101
100000000000000000000000001
111111111111111111111111111