111111111111111111111111111
1CCXCCCCCCCCC1CCCCCCCCCXCC1
1C1111C11111C1C11111C1111C1
1C1111C11111C1C11111C1111C1
1C1111C11111C1C11111C1111C1
1CCCCCCCCCCCCCCCCCCCCCCCCC1
1C1111C1C111111111C1C1111C1
1CCCCCC1CCCCC1CCCCC1CCCCCC1
111111C11111C1C11111C111111
111111C1CCCCC1CCCCC1C111111
111111C1C111111111C1C111111
111111C1CCCCCCCCCCC1C111111
100000CCC111101111CCC000001
111111C1C1000E0001C1C111111
111111C1C111111111C1C111111
111111C1CCCCCCCCCCC1C111111
111111C1C111111111C1C111111
1CCCCCCCCCCC111CCCCCCCCCCC1
1C1111C1111C111C1111C1111C1
1CCCC1CCCC1CCCCC1CCCC1CCCC1
1111C1C11C1111111C11C1C1111
1CCCCCC11CCCC1CCCC11CCCCCC1
1C1111111111C1C1111111111C1
1PCCCCCCCCCCCCCCCCCCCCCCCC1
111111111111111111111111111