111111111111111111111111111
1C0X0C0C0C0C010C0C0C0C0X0C1
101111011111C1C111110111101
1C1111C1111101011111C1111C1
101111011111C1C111110111101
1C0C0C0C0C0C000C0C0C0C0C0C1
101111C1C111111111C1C111101
1C0C0C010C0C010C0C010C0C0C1
111111C11111C1C11111C111111
111111010C0C010C0C010111111
111111C1C111111111C1C111111
111111010C0C0C0C0C010111111
100000C0C111111111C0C000001
1111110101000E0001010111111
111111C1C111111111C1C111111
111111010C0C0C0C0C010111111
111111C1C111111111C1C111111
1C0C0C0C0C0C111C0C0C0C0C0C1
10111101111011101111C111101
1C0C010C0C1C0C0C1C0C010C0C1
1111C101101111111011C1C1111
1C0C0C011C0C010C0C110C0C0C1
101111111111C1C111111111101
1P0C0C0C0C0C0C0C0C0C0C0C0C1
111111111111111111111111111